2,2,2,2,2,2,2,2,2,2
2,0,12,12,1,2,2,2,2,2
2,12,12,12,12,2,2,2,2
2,10,12,12,11,2,2,2,2
2,2,2,2,2,2,2,2,2,2